190,190,190,190,190,190,190,190,190,190
190,190,190,190,190,190,190,190,190,190
190,704,705,706,190,704,705,706,190,704
190,736,737,738,190,736,737,738,190,736
190,768,769,770,190,768,769,770,190,768
190,190,190,190,190,190,190,190,190,190
190,190,190,190,190,190,190,190,190,190
190,190,190,190,190,190,190,190,190,190
190,190,190,190,190,190,190,190,190,190
190,190,190,190,190,190,190,190,190,190
