737,738,997,736,737,738,997,736,737,738
769,770,997,768,769,770,997,768,769,770
997,997,997,997,997,997,997,997,997,997
704,705,706,997,704,705,706,997,704,705
736,737,738,997,736,737,738,997,736,737
768,769,770,997,768,769,770,997,768,769
997,997,997,997,997,997,997,997,997,997
997,704,705,706,997,704,705,706,997,704
997,736,737,738,997,736,737,738,997,736
997,768,769,770,997,768,769,770,997,768
